----------------------------
----------------------------
----------------------------
----------------------------
############################
#............##............#
#.####.#####.##.#####.####.#
#o####.#####.##.#####.####o#
#.####.#####.##.#####.####.#
#..........................#
#.####.##.########.##.####.#
#.####.##.########.##.####.#
#......##....##....##......#
######.#####.##.#####.######
######.#####.##.#####.######
#......##....##....##......#
#.####.##.########.##.####.#
#.####.##...####...##.####.#
#......###..####..###......#
######.#..........#.########
      .#.########.#.        
######.#.########.#.########
#............##............#
#.####.#####.##.#####.####.#
#.####.#####.##.#####.####.#
#o..##................##..o#
###.##.##.########.##.##.###
###.##.##.########.##.##.###
#......##....##....##......#
#.##########.##.##########.#
#.##########.##.##########.#
#..........................#
############################
----------------------------
----------------------------
----------------------------